XXXXXXXXXXXXXXXXXXXXXX
X32123212111X2323a112X
X22322241111X22234121X
X12d2234131XX111X1111X
XXXXXXXXXX1X1XXXX1211X
X12111121125211111233X
X111121111111111X2XX2X
X22X12111XXXXXXXX1211X
X232X211X222X111X1XXXX
X2221412X2e2X122X22c2X
X11b1121X222X223X3233X
XXXXXXXXXXXXXXXXXXXXXX
